111111111111111
100000000000001
100111111000001
100000000000001
100000000000001
100000001100001
100000000000001
111111111111111