111111111111111
10C000000000001
100P11111000001
100000000000001
100000000000001
100000001100001
100000000000001
111111111111101
1100000000E0001
111111111111111
