111111111111111
10C000000000001
100P11111000001
100000000000001
100000000000001
1000000011E0001
100000000000001
111111111111101
10C000000000001
111111111111111
