111111111111111
1000000000000E1
100111111000001
10000000000C001
100000000000001
100P00001100001
100000000000001
111111111111111
