111111111111111
10CE00000000001
100P11111000001
100000000000001
100000000000001
100000001100001
100000000000001
111111111111111
110000000000001
111111111111111
