111111111
100000001
100C00101
111000E01
1C00000C1
1000P0001
111111111
