111111111111111111111111
1EC000000000000000000001
1CC000000000000000000001
100000000000000000000001
100000000000000000000001
100000000000000000000001
1000000000000000000000P1
111111111111111111111111
